155412344321
225552421242
124552421242
123452423412
435555521242
225412555412
125534125555
123434123455